NO	./assets/NO.xpm42
SO	./assets/SO.xpm42
WE	./assets/WE.xpm42
EA	./assets/EA.xpm42

C      169,169,169
F      112,128,144

111111111111111111111111111111111111111111111111111111111111111111111111111
100000000011000100000000011000100000000011000100000000011000100000000011001
100000000011000100000000011000100000000011000100000000011000100000000011001
100000000011000100000000011000100000000011000100000000011000100000000011001
100000000011000100000000011000100000000011000100000000011000100000000011001
100000000011000100000000011000100000000011000100000000011000100000000011001
100000000011000100000000011000100000000011000100000000011000100000000011001
100000000011000100000000011000100000000011000100000000011000100000000011001
100000000011000100000000011000100000000011000100000000011000100000000011001
100000000011000100000000011000100000000011000100000000011000100000000011001
100000000011000100000000011000100000000011000100000000011000100000000011001
100000000011000100000000011000100000000011000100000000011000100000000011001
100000000011000100000000011000100000000011000100000000011000100000000011001
100000000011000100000000011000100000000011000100000000011000100000000011001
100000000011000100000000011000100000000011000100000000011000100000000011001
100000000011000100000000011000100000000011000100000000011000100000000011001
100000000011000100000000011000100000000011000100000000011000100000000011001
100000000011000100000000011000100000000011000100000000011000100000000011001
100000000011000100000000011000100000000011000100000000011000100000000011001
100000000011000100000000011000100000000011000100000000011000100000000011001
100000000011000100000000011000100000000011000100000000011000100000000011001
100000000011000100000000011000100000000011000100000000011000100000000011001
100000000011000100000000011000100000000011000100000000011000100000000011001
100000000011000100000000011000100000000011000100000000011000100000000011001
100000000011000100000000011000100000000011000100000000011000100000000011001
100000000011000100000000011000100000000011000100000000011000100000000011001
100000000011000100000000011000100000000011000100000000011000100000000011001
100000000011000100000000011000100000000011000100000000011000100000000011001
100000000011000100000000011000100000N00011000100000000011000100000000011001
100000000011000100000000011000100000000011000100000000011000100000000011001
100000000011000100000000011000100000000011000100000000011000100000000011001
100000000011000100000000011000100000000011000100000000011000100000000011001
100000000011000100000000011000100000000011000100000000011000100000000011001
100000000011000100000000011000100000000011000100000000011000100000000011001
100000000011000100000000011000100000000011000100000000011000100000000011001
111111111111111111111111111111111111111111111111111111111111111111111111111