NO	./assets/NO.xpm42
SO	./assets/SO.xpm42
WE	./assets/WE.xpm42
EA	./assets/EA.xpm42


C      112,128,144
F      112,128,144

1111111111111111
100000100000001
100001111111111111111 111
10000011000000000000010001
10000010000000000000000001
100000110000N0000000010001
11101111111011111111110001
11111111111111111111111111
1111111111111111
100000100000001
100001111111111111111 111
10000011000000000000010001
10000010000000000000000001
10000011000000000000010001
11101111111011111111110001
11111111111111111111111111
1111111111111111
100000100000001
100001111111111111111 111
10000011000000000000010001
10000010000000000000000001
10000011000000000000010001
11101111111011111111110001
111111111111111111111111111111111111111111
100000100000001
100001111111111111111 111
10000011000000000000010001
10000010000000000000000001
10000011000000000000010001
11101111111011111111110001
111111111111111111111111111111111111111111
100000100000001
100001111111111111111 111
10000011000000000000010001
10000010000000000000000001
10000011000000000000010001
11101111111011111111110001
111111111111111111111111111111111111111111
100000100000001
100001111111111111111 111
10000011000000000000010001
10000010000000000000000001
10000011000000000000010001
11101111111011111111110001
111111111111111111111111111111111111111111
100000100000001
100001111111111111111 111
10000011000000000000010001
10000010000000000000000001
10000011000000000000010001
11101111111011111111110001
111111111111111111111111111111111111111111
100000100000001
100001111111111111111 111
10000011000000000000010001
10000010000000000000000001
10000011000000000000010001
11101111111011111111110001
111111111111111111111111111111111111111111
100000100000001
100001111111111111111 111
10000011000000000000010001
10000010000000000000000001
10000011000000000000010001
11101111111011111111110001
111111111111111111111111111111111111111111
100000100000001
100001111111111111111 111
10000011000000000000010001
10000010000000000000000001
10000011000000000000010001
11101111111011111111110001
111111111111111111111111111111111111111111
100000100000001
100001111111111111111 111
10000011000000000000010001
10000010000000000000000001
10000011000000000000010001
11101111111011111111110001
111111111111111111111111111111111111111111
100000100000001
100001111111111111111 111
10000011000000000000010001
10000010000000000000000001
10000011000000000000010001
11101111111011111111110001
111111111111111111111111111111111111111111
100000100000001
100001111111111111111 111
10000011000000000000010001
10000010000000000000000001
10000011000000000000010001
11101111111011111111110001
111111111111111111111111111111111111111111
100000100000001
100001111111111111111 111
10000011000000000000010001
10000010000000000000000001
10000011000000000000010001
11101111111011111111110001
11111111111111111111111111
111111111111111111111111111111111111111111
100000100000001
100001111111111111111 111
10000011000000000000010001
10000010000000000000000001
10000011000000000000010001
11101111111011111111110001
111111111111111111111111111111111111111111
100000100000001
100001111111111111111 111
10000011000000000000010001
10000010000000000000000001
10000011000000000000010001
11101111111011111111110001
11111111111111111111111111111111111111111111111111111111111111111111
100000100000001
100001111111111111111 111
10000011000000000000010001
10000010000000000000000001
10000011000000000000010001
11101111111011111111110001
111111111111111111111111111111111111111111
100000100000001
100001111111111111111 111
10000011000000000000010001
10000010000000000000000001
10000011000000000000010001
11101111111011111111110001
11111111111111111111111111111111111111111111111111111111111111111111
100000100000001
100001111111111111111 111
10000011000000000000010001
10000010000000000000000001
10000011000000000000010001
11101111111011111111110001
111111111111111111111111111111111111111111
100000100000001
100001111111111111111 111
10000011000000000000010001
10000010000000000000000001
10000011000000000000010001
11101111111011111111110001
11111111111111111111111111111111111111111111111111111111111111111111
100000100000001
100001111111111111111 111
10000011000000000000010001
10000010000000000000000001
10000011000000000000010001
11101111111011111111110001
111111111111111111111111111111111111111111
100000100000001
100001111111111111111 111
10000011000000000000010001
10000010000000000000000001
10000011000000000000010001
11101111111011111111110001
11111111111111111111111111111111111111111111111111111111111111111111
100000100000001
100001111111111111111 111
10000011000000000000010001
10000010000000000000000001
10000011000000000000010001
11101111111011111111110001
111111111111111111111111111111111111111111
100000100000001
100001111111111111111 111
10000011000000000000010001
10000010000000000000000001
10000011000000000000010001
11101111111011111111110001
11111111111111111111111111111111111111111111111111111111111111111111
100000100000001
100001111111111111111 111
10000011000000000000010001
10000010000000000000000001
10000011000000000000010001
11101111111011111111110001
111111111111111111111111111111111111111111
100000100000001
100001111111111111111 111
10000011000000000000010001
10000010000000000000000001
10000011000000000000010001
11101111111011111111110001
11111111111111111111111111111111111111111111111111111111111111111111
100000100000001
100001111111111111111 111
10000011000000000000010001
10000010000000000000000001
10000011000000000000010001
11101111111011111111110001
111111111111111111111111111111111111111111
100000100000001
100001111111111111111 111
10000011000000000000010001
10000010000000000000000001
10000011000000000000010001
11101111111011111111110001
11111111111111111111111111111111111111111111111111111111111111111111
100000100000001
100001111111111111111 111
10000011000000000000010001
10000010000000000000000001
10000011000000000000010001
11101111111011111111110001
111111111111111111111111111111111111111111
100000100000001
100001111111111111111 111
10000011000000000000010001
10000010000000000000000001
10000011000000000000010001
11101111111011111111110001
11111111111111111111111111111111111111111111111111111111111111111111
100000100000001
100001111111111111111 111
10000011000000000000010001
10000010000000000000000001
10000011000000000000010001
11101111111011111111110001
111111111111111111111111111111111111111111
100000100000001
100001111111111111111 111
10000011000000000000010001
10000010000000000000000001
10000011000000000000010001
11101111111011111111110001
11111111111111111111111111111111111111111111111111111111111111111111
100000100000001
100001111111111111111 111
10000011000000000000010001
10000010000000000000000001
10000011000000000000010001
11101111111011111111110001
111111111111111111111111111111111111111111
100000100000001
100001111111111111111 111
10000011000000000000010001
10000010000000000000000001
10000011000000000000010001
11101111111011111111110001
11111111111111111111111111