NO	./assets/NO.xpm42
SO	./assets/SO.xpm42
WE	./assets/WE.xpm42
EA	./assets/EA.xpm42

F	68, 68,  68
C	51, 204, 255

11111111
10000001
100N0001
10000001
11111111